{
  "version": "2.1",
  "last_updated": "2025-09-09",
  "maps": {
    "Нижний Лабиринт": {
      "От ВВ до старой деревни": {
        "ЛБВ": {
          "id": 100,
          "name": "Лабиринт Бушующих Волн",
          "cells": [
            { "row": 1, "col": 5 },
            { "row": 1, "col": 1 },
            { "row": 3, "col": 6 },
            { "row": 4, "col": 1 },
            { "row": 1, "col": 2 },
            { "row": 3, "col": 1 },
            { "row": 4, "col": 3 },
            { "row": 2, "col": 6 },
            { "row": 6, "col": 8 },
            { "row": 3, "col": 6 },
            { "row": 6, "col": 9 },
            { "row": 3, "col": 1 },
            { "row": 5, "col": 8 },
            { "row": 6, "col": 7 },
            { "row": 5, "col": 6 },
            { "row": 4, "col": 5 },
            { "row": 1, "col": 3 },
            { "row": 2, "col": 7 },
            { "row": 4, "col": 8 },
            { "row": 6, "col": 8 },
            { "row": 4, "col": 4 },
            { "row": 1, "col": 8 },
            { "row": 2, "col": 7 },
            { "row": 3, "col": 4 },
            { "row": 2, "col": 8 },
            { "row": 6, "col": 4 },
            { "row": 4, "col": 3 },
            { "row": 2, "col": 1 },
            { "row": 6, "col": 4 },
            { "row": 1, "col": 6 },
            { "row": 5, "col": 9 },
            { "row": 3, "col": 7 },
            { "row": 1, "col": 7 },
            { "row": 4, "col": 7 },
            { "row": 5, "col": 7 },
            { "row": 4, "col": 9 },
            { "row": 1, "col": 8 },
            { "row": 4, "col": 2 },
            { "row": 2, "col": 3 },
            { "row": 1, "col": 2 },
            { "row": 6, "col": 1 },
            { "row": 5, "col": 3 },
            { "row": 4, "col": 3 },
            { "row": 1, "col": 6 },
            { "row": 3, "col": 6 },
            { "row": 5, "col": 8 },
            { "row": 4, "col": 4 },
            { "row": 1, "col": 6 },
            { "row": 6, "col": 9 },
            { "row": 3, "col": 3 },
            { "row": 6, "col": 6 },
            { "row": 3, "col": 4 },
            { "row": 3, "col": 4 },
            { "row": 5, "col": 1 },
            { "row": 2, "col": 9 },
            { "row": 5, "col": 8 },
            { "row": 5, "col": 4 },
            { "row": 2, "col": 6 },
            { "row": 2, "col": 8 },
            { "row": 2, "col": 6 },
            { "row": 6, "col": 8 },
            { "row": 6, "col": 7 },
            { "row": 1, "col": 5 },
            { "row": 2, "col": 4 },
            { "row": 1, "col": 4 },
            { "row": 6, "col": 9 },
            { "row": 6, "col": 9 },
            { "row": 4, "col": 2 },
            { "row": 3, "col": 1 },
            { "row": 1, "col": 5 },
            { "row": 2, "col": 3 },
            { "row": 3, "col": 5 },
            { "row": 5, "col": 3 },
            { "row": 4, "col": 8 },
            { "row": 6, "col": 7 },
            { "row": 1, "col": 8 },
            { "row": 1, "col": 3 },
            { "row": 1, "col": 9 },
            { "row": 4, "col": 1 },
            { "row": 5, "col": 2 },
            { "row": 1, "col": 2 },
            { "row": 6, "col": 5 },
            { "row": 2, "col": 7 },
            { "row": 1, "col": 1 },
            { "row": 1, "col": 6 },
            { "row": 1, "col": 5 },
            { "row": 6, "col": 4 },
            { "row": 1, "col": 2 },
            { "row": 2, "col": 6 },
            { "row": 1, "col": 9 },
            { "row": 3, "col": 1 },
            { "row": 6, "col": 8 },
            { "row": 1, "col": 8 },
            { "row": 2, "col": 8 },
            { "row": 6, "col": 5 },
            { "row": 2, "col": 4 },
            { "row": 2, "col": 8 },
            { "row": 3, "col": 3 },
            { "row": 6, "col": 3 },
            { "row": 6, "col": 6 }
          ]
        }
      },
      "От старой деревни до ВВ": {
        // Добавить карты
      }
    },
    "Верхний Лабиринт": {
      "От старой деревни до нейтральной территории": {
        // Добавить карты
      },
      "От нейтральной территории до старой деревни": {
        // Добавить карты
      }
    }
  }
}
